"aa" = (/turf/space,/area/space)
"ab" = (/turf/simulated/wall/r_wall,/area/space)
"ac" = (/turf/simulated/floor/airless/ceiling,/area/space)
"ad" = (/turf/simulated/floor/airless,/area/space)
"ae" = (/obj/machinery/button{id = 2; pixel_y = 32},/turf/simulated/floor/airless/ceiling,/area/space)
"af" = (/obj/structure/ore_box,/turf/simulated/floor/airless/ceiling,/area/space)
"ag" = (/obj/random,/obj/structure/largecrate,/turf/simulated/floor/airless/ceiling,/area/space)
"ah" = (/obj/structure/barrel,/turf/simulated/floor/airless/ceiling,/area/space)
"ai" = (/obj/random/ammo,/obj/structure/largecrate,/turf/simulated/floor/airless/ceiling,/area/space)
"aj" = (/obj/random/handgun,/obj/structure/largecrate,/turf/simulated/floor/airless/ceiling,/area/space)
"ak" = (/obj/structure/reagent_dispensers/fueltank,/turf/simulated/floor/airless/ceiling,/area/space)
"al" = (/obj/structure/reagent_dispensers/coolanttank,/turf/simulated/floor/airless/ceiling,/area/space)
"am" = (/obj/random/toolbox,/turf/simulated/floor/airless/ceiling,/area/space)
"an" = (/obj/item/robot_parts/l_leg,/obj/structure/largecrate,/turf/simulated/floor/airless/ceiling,/area/space)
"ao" = (/obj/item/robot_parts/chest,/obj/structure/largecrate,/turf/simulated/floor/airless/ceiling,/area/space)
"ap" = (/obj/item/robot_parts/r_arm,/obj/structure/largecrate,/turf/simulated/floor/airless/ceiling,/area/space)
"aq" = (/obj/structure/closet/crate/secure/loot,/turf/simulated/floor/airless/ceiling,/area/space)
"ar" = (/obj/machinery/power/apc{cell_type = /obj/item/weapon/cell/infinite; pixel_y = 32},/turf/simulated/floor/airless/ceiling,/area/space)
"as" = (/obj/machinery/door/blast/regular,/turf/simulated/floor/airless,/area/space)
"at" = (/obj/random/cash,/obj/structure/largecrate,/turf/simulated/floor/airless/ceiling,/area/space)
"au" = (/obj/structure/largecrate,/turf/simulated/floor/airless/ceiling,/area/space)
"av" = (/obj/random/smokes,/obj/structure/largecrate,/turf/simulated/floor/airless/ceiling,/area/space)
"aw" = (/obj/structure/reagent_dispensers/watertank,/turf/simulated/floor/airless/ceiling,/area/space)
"ax" = (/obj/item/robot_parts/robot_suit,/obj/structure/largecrate,/turf/simulated/floor/airless/ceiling,/area/space)
"ay" = (/obj/item/robot_parts/head,/obj/structure/largecrate,/turf/simulated/floor/airless/ceiling,/area/space)
"az" = (/obj/random,/obj/random,/obj/structure/largecrate,/turf/simulated/floor/airless/ceiling,/area/space)
"aA" = (/obj/machinery/door/blast/regular{id = 2},/turf/simulated/floor/airless,/area/space)
"aB" = (/obj/random/ammo,/obj/random/smokes,/obj/structure/largecrate,/turf/simulated/floor/airless/ceiling,/area/space)
"aC" = (/turf/simulated/wall/r_wall,/area/maintenance)
"aD" = (/obj/machinery/atmospherics/pipe/tank/phoron{tag = "icon-phoron_map (EAST)"; icon_state = "phoron_map"; dir = 4},/turf/simulated/floor,/area/space)
"aE" = (/obj/structure/window/reinforced{tag = "icon-rwindow (EAST)"; icon_state = "rwindow"; dir = 4},/obj/machinery/atmospherics/pipe/simple/visible/fuel{tag = "icon-intact (EAST)"; icon_state = "intact"; dir = 4},/turf/simulated/floor,/area/space)
"aF" = (/obj/structure/shuttle/engine/propulsion{icon_state = "propulsion"; dir = 8},/turf/space,/area/space)
"aG" = (/obj/effect/decal/warning_stripes,/turf/simulated/floor/airless/ceiling,/area/space)
"aH" = (/obj/structure/oxy_dispenser/large,/turf/simulated/wall/r_wall,/area/maintenance)
"aI" = (/obj/structure/closet/secure_closet/engineering_personal,/turf/simulated/floor/tiled,/area/maintenance)
"aJ" = (/obj/machinery/light{dir = 1},/obj/item/weapon/storage/toolbox/mechanical,/obj/structure/table/steel,/turf/simulated/floor/tiled,/area/maintenance)
"aK" = (/obj/structure/table/steel,/obj/random/snack,/turf/simulated/floor/tiled,/area/maintenance)
"aL" = (/obj/structure/toilet,/obj/machinery/power/apc{cell_type = /obj/item/weapon/cell/infinite; pixel_y = 32},/turf/simulated/floor/tiled,/area/maintenance)
"aM" = (/obj/structure/closet/crate/freezer/rations,/turf/simulated/floor/tiled,/area/maintenance)
"aN" = (/obj/structure/window/reinforced,/obj/structure/window/reinforced{tag = "icon-rwindow (EAST)"; icon_state = "rwindow"; dir = 4},/obj/machinery/atmospherics/pipe/simple/visible/fuel{tag = "icon-intact (EAST)"; icon_state = "intact"; dir = 4},/turf/simulated/floor,/area/space)
"aO" = (/obj/structure/shuttle/engine/propulsion{icon_state = "burst_l"; dir = 8},/turf/space,/area/space)
"aP" = (/obj/docking_umbilical/east{name = "Container Umbilical"},/turf/simulated/floor/airless/ceiling,/area/space)
"aQ" = (/obj/random/projectile,/obj/structure/largecrate,/turf/simulated/floor/airless/ceiling,/area/space)
"aR" = (/obj/structure/closet/crate/secure/gear,/obj/random/gloves,/obj/random/shoes,/turf/simulated/floor/airless/ceiling,/area/space)
"aS" = (/obj/structure/reagent_dispensers/beerkeg,/turf/simulated/floor/airless/ceiling,/area/space)
"aT" = (/obj/structure/grille,/turf/space,/area/space)
"aU" = (/turf/simulated/floor/plating,/area/maintenance)
"aV" = (/obj/machinery/alarm{pixel_y = 32},/turf/simulated/floor/tiled,/area/maintenance)
"aW" = (/obj/machinery/light{icon_state = "tube1"; dir = 4},/obj/structure/closet/walllocker/emerglocker/north,/turf/simulated/floor/tiled,/area/maintenance)
"aX" = (/turf/simulated/wall,/area/maintenance)
"aY" = (/turf/simulated/floor/tiled,/area/maintenance)
"aZ" = (/obj/machinery/light{icon_state = "tube1"; dir = 4},/turf/simulated/floor/tiled,/area/maintenance)
"ba" = (/obj/structure/window/reinforced{tag = "icon-rwindow (EAST)"; icon_state = "rwindow"; dir = 4},/turf/simulated/floor,/area/maintenance)
"bb" = (/obj/machinery/light/invis,/turf/simulated/floor/airless/ceiling,/area/space)
"bc" = (/obj/machinery/door/airlock/external,/turf/simulated/floor/airless,/area/space)
"bd" = (/obj/structure/lattice,/turf/space,/area/space)
"be" = (/obj/machinery/door/airlock/glass_external,/turf/simulated/floor/plating,/area/maintenance)
"bf" = (/obj/machinery/door/airlock/external,/obj/machinery/door/firedoor,/turf/simulated/floor/plating,/area/maintenance)
"bg" = (/obj/machinery/door/airlock,/obj/machinery/door/firedoor,/turf/simulated/floor/tiled,/area/maintenance)
"bh" = (/obj/machinery/portable_atmospherics/canister/air{anchored = 1},/turf/simulated/floor/tiled,/area/maintenance)
"bi" = (/obj/structure/grille,/turf/simulated/floor/airless/ceiling,/area/space)
"bj" = (/obj/effect/decal/warning_stripes,/obj/machinery/button{id = 2; pixel_x = 32},/turf/simulated/floor/airless/ceiling,/area/space)
"bk" = (/obj/random/ammo,/obj/random/ammo,/obj/structure/largecrate,/turf/simulated/floor/airless/ceiling,/area/space)
"bl" = (/obj/structure/janitorialcart,/turf/simulated/floor/airless/ceiling,/area/space)
"bm" = (/obj/machinery/light{dir = 8; icon_state = "tube1"; pixel_y = 0},/turf/simulated/floor/plating,/area/maintenance)
"bn" = (/obj/machinery/computer/station_alert,/turf/simulated/floor/tiled,/area/maintenance)
"bo" = (/obj/machinery/computer/power_monitor,/turf/simulated/floor/tiled,/area/maintenance)
"bp" = (/turf/simulated/floor/tiled,/area/centcom/holding)
"bq" = (/obj/machinery/door/airlock/glass_external,/turf/simulated/floor/plating,/area/centcom/holding)
"br" = (/obj/item/modular_computer/console,/turf/simulated/floor/airless/ceiling,/area/space)
"bs" = (/obj/machinery/light/small{dir = 4; pixel_y = 8},/turf/simulated/floor/airless/ceiling,/area/space)
"bt" = (/obj/machinery/door/airlock/halo_maint,/turf/simulated/floor/airless/ceiling,/area/space)
"bu" = (/obj/machinery/door/airlock/multi_tile/halo/blast,/turf/simulated/floor/airless/ceiling,/area/space)
"bv" = (/obj/machinery/door/airlock/glass_external,/obj/machinery/door/firedoor,/turf/simulated/floor/tiled,/area/maintenance)
"bw" = (/obj/machinery/computer/navigation,/turf/simulated/floor/tiled,/area/maintenance)
"bx" = (/obj/structure/bed/chair{dir = 8},/turf/simulated/floor/tiled,/area/maintenance)
"by" = (/obj/machinery/light{icon_state = "tube1"; dir = 4},/turf/simulated/floor/tiled,/area/centcom/holding)
"bz" = (/turf/simulated/wall/r_wall,/area/centcom/holding)
"bA" = (/obj/effect/decal/warning_stripes,/obj/machinery/button{id = 1; pixel_x = 32},/turf/simulated/floor/airless/ceiling,/area/space)
"bB" = (/obj/random/drinkbottle,/obj/random/drinkbottle,/obj/structure/largecrate,/turf/simulated/floor/airless/ceiling,/area/space)
"bC" = (/obj/random/plushie,/obj/structure/largecrate,/turf/simulated/floor/airless/ceiling,/area/space)
"bD" = (/obj/random/contraband,/obj/structure/largecrate,/turf/simulated/floor/airless/ceiling,/area/space)
"bE" = (/obj/structure/closet/crate/large/hydroponics,/obj/random/projectile,/turf/simulated/floor/airless/ceiling,/area/space)
"bF" = (/obj/random/tool,/turf/simulated/floor/airless/ceiling,/area/space)
"bG" = (/obj/machinery/computer/helm,/turf/simulated/floor/tiled,/area/maintenance)
"bH" = (/obj/machinery/computer/engines,/turf/simulated/floor/tiled,/area/maintenance)
"bI" = (/obj/machinery/alarm{pixel_y = -32},/turf/simulated/floor/tiled,/area/maintenance)
"bJ" = (/obj/machinery/light{icon_state = "tube1"; dir = 4},/obj/structure/closet/walllocker/emerglocker/south,/turf/simulated/floor/tiled,/area/maintenance)
"bK" = (/obj/machinery/light{icon_state = "tube1"; dir = 4},/obj/structure/table/steel,/obj/structure/closet/medical_wall/filled{pixel_x = 24},/turf/simulated/floor/tiled,/area/maintenance)
"bL" = (/obj/effect/decal/warning_stripes,/turf/simulated/floor/airless,/area/space)
"bM" = (/obj/structure/bed,/obj/item/weapon/bedsheet,/obj/structure/oxy_dispenser/large{pixel_y = -32},/turf/simulated/floor/tiled,/area/maintenance)
"bN" = (/obj/structure/closet/wardrobe,/obj/item/clothing/under/frontier,/obj/random/shoes,/obj/random/shoes,/obj/item/clothing/under/serviceoveralls,/obj/item/clothing/under/confederacy,/obj/random/gloves,/obj/random/handgun,/turf/simulated/floor/tiled,/area/maintenance)
"bO" = (/obj/machinery/vending/wallmed1{pixel_x = 28},/obj/structure/table/steel,/obj/random/firstaid,/turf/simulated/floor/tiled,/area/maintenance)
"bP" = (/obj/structure/window/reinforced{tag = "icon-rwindow (NORTH)"; icon_state = "rwindow"; dir = 1},/obj/structure/window/reinforced{tag = "icon-rwindow (EAST)"; icon_state = "rwindow"; dir = 4},/obj/machinery/atmospherics/pipe/simple/visible/fuel{tag = "icon-intact (EAST)"; icon_state = "intact"; dir = 4},/turf/simulated/floor,/area/space)
"bQ" = (/obj/docking_umbilical/east{name = "Cargo Umbilical"},/turf/simulated/floor/airless,/area/space)
"bR" = (/obj/machinery/door/blast/regular,/turf/simulated/floor/airless/ceiling,/area/space)
"bS" = (/obj/structure/ore_box,/turf/simulated/floor/airless,/area/space)
"bT" = (/obj/random/hat,/obj/random/shoes,/obj/structure/largecrate,/turf/simulated/floor/airless/ceiling,/area/space)
"bU" = (/obj/random/clothing,/obj/random/shoes,/obj/random/masks,/obj/random/gloves,/obj/structure/largecrate,/turf/simulated/floor/airless/ceiling,/area/space)
"bV" = (/obj/item/pizzabox/meat,/obj/item/pizzabox/mushroom,/turf/simulated/floor/airless/ceiling,/area/space)
"bW" = (/obj/item/pizzabox/margherita,/turf/simulated/floor/airless/ceiling,/area/space)
"bX" = (/obj/item/pizzabox/meat,/obj/item/pizzabox/margherita,/turf/simulated/floor/airless/ceiling,/area/space)
"bY" = (/obj/structure/closet/crate/secure/weapon,/obj/random/handgun,/turf/simulated/floor/airless/ceiling,/area/space)
"bZ" = (/obj/item/pizzabox/mushroom,/obj/item/pizzabox/mushroom,/obj/item/pizzabox/vegetable,/turf/simulated/floor/airless/ceiling,/area/space)
"ca" = (/obj/item/pizzabox/meat,/obj/item/pizzabox/vegetable,/obj/item/pizzabox/vegetable,/turf/simulated/floor/airless/ceiling,/area/space)
"cb" = (/obj/item/pizzabox/margherita,/obj/item/pizzabox/margherita,/obj/item/pizzabox/vegetable,/turf/simulated/floor/airless/ceiling,/area/space)
"cc" = (/obj/random/firstaid,/obj/structure/largecrate,/turf/simulated/floor/airless/ceiling,/area/space)
"cd" = (/obj/structure/closet/crate/secure/weapon,/obj/random/ammo,/turf/simulated/floor/airless/ceiling,/area/space)
"ce" = (/obj/machinery/button{id = 1; pixel_y = -32},/turf/simulated/floor/airless/ceiling,/area/space)
"cf" = (/obj/random/storage,/obj/structure/largecrate,/turf/simulated/floor/airless/ceiling,/area/space)
"cg" = (/obj/random/tool,/obj/structure/largecrate,/turf/simulated/floor/airless/ceiling,/area/space)
"ch" = (/obj/item/pizzabox/meat,/obj/item/pizzabox/meat,/turf/simulated/floor/airless/ceiling,/area/space)
"ci" = (/obj/item/pizzabox/mushroom,/obj/item/pizzabox/margherita,/turf/simulated/floor/airless/ceiling,/area/space)
"cj" = (/obj/item/pizzabox/meat,/obj/item/pizzabox/margherita,/obj/item/pizzabox/vegetable,/turf/simulated/floor/airless/ceiling,/area/space)

(1,1,1) = {"
aaaaaaaaaaaaaaaaaaaaaaaaaaaaaaaaaaaaaaaaaaaaaaaaaaaaaaaaaaaaaaaaaaaaaaaaaaaaaaaaaaaaaaaaaaaaaaaaaaaaaaaaaaaaaaaaaaaaaaaaaaaaaaaaaaaaaaaaaaaaaaaaaaaaaa
aaaaaaaaaaaaaaaaaaaaaaaaaaaaaaaaaaaaaaaaaaaaaaaaaaaaaaaaaaaaaaaaaaaaaaaaaaaaaaaaaaaaaaaaaaaaaaaaaaaaaaaaaaaaaaaaaaaaaaaaaaaaaaaaaaaaaaaaaaaaaaaaaaaaaa
aaaaaaaaaaaaaaaaaaaaaaaaaaaaaaaaaaaaaaaaaaaaaaaaaaaaaaaaaaaaaaaaaaaaaaaaaaaaaaaaaaaaaaaaaaaaaaaaaaaaaaaaaaaaaaaaaaaaaaaaaaaaaaaaaaaaaaaaaaaaaaaaaaaaaa
aaaaaaaaaaaaaaaaaaaaaaaaaaaaaaaaaaaaaaaaaaaaaaaaaaaaaaaaaaaaaaaaaaaaaaaaaaaaaaaaaaaaaaaaaaaaaaaaaaaaaaaaaaaaaaaaaaaaaaaaaaaaaaaaaaaaaaaaaaaaaaaaaaaaaa
aaaaaaaaaaaaaaaaaaaaaaaaaaaaaaaaaaaaaaaaaaaaaaaaaaaaaaaaaaaaaaaaaaaaaaaaaaaaaaaaaaaaaaaaaaaaaaaaaaaaaaaaaaaaaaaaaaaaaaaaaaaaaaaaaaaaaaaaaaaaaaaaaaaaaa
aaaaaaaaaaaaaaaaaaaaaaaaaaaaaaaaaaaaaaaaaaaaaaaaaaaaaaaaaaaaaaaaaaaaaaaaaaaaaaaaaaaaaaaaaaaaaaaaaaaaaaaaaaaaaaaaaaaaaaaaaaaaaaaaaaaaaaaaaaaaaaaaaaaaaa
aaaaaaaaaaaaaaaaaaaaaaaaaaaaaaaaaaaaaaaaaaaaaaaaaaaaaaaaaaaaaaaaaaaaaaaaaaaaaaaaaaaaaaaaaaaaaaaaaaaaaaaaaaaaaaaaaaaaaaaaaaaaaaaaaaaaaaaaaaaaaaaaaaaaaa
aaaaaaaaaaaaaaaaaaaaaaaaaaaaaaaaaaaaaaaaaaaaaaaaaaaaaaaaaaaaaaaaaaaaaaaaaaaaaaaaaaaaaaaaaaaaaaaaaaaaaaaaaaaaaaaaaaaaaaaaaaaaaaaaaaaaaaaaaaaaaaaaaaaaaa
aaaaaaaaaaaaaaaaaaaaaaaaaaaaaaaaaaaaaaaaaaaaaaaaaaaaaaaaaaaaaaaaaaaaaaaaaaaaaaaaaaaaaaaaaaaaaaaaaaaaaaaaaaaaaaaaaaaaaaaaaaaaaaaaaaaaaaaaaaaaaaaaaaaaaa
aaaaaaaaaaaaaaaaaaaaaaaaaaaaaaaaaaaaaaaaaaaaaaaaaaaaaaaaaaaaaaaaaaaaaaaaaaaaaaaaaaaaaaaaaaaaaaaaaaaaaaaaaaaaaaaaaaaaaaaaaaaaaaaaaaaaaaaaaaaaaaaaaaaaaa
aaaaaaaaaaaaaaaaaaaaaaaaaaaaaaaaaaaaaaaaaaaaaaaaaaaaaaaaaaaaaaaaaaaaaaaaaaaaaaaaaaaaaaaaaaaaaaaaaaaaaaaaaaaaaaaaaaaaaaaaaaaaaaaaaaaaaaaaaaaaaaaaaaaaaa
aaaaaaaaaaaaaaaaaaaaaaaaaaaaaaaaaaaaaaaaaaaaaaaaaaaaaaaaaaaaaaaaaaaaaaaaaaaaaaaaaaaaaaaaaaaaaaaaaaaaaaaaaaaaaaaaaaaaaaaaaaaaaaaaaaaaaaaaaaaaaaaaaaaaaa
aaaaaaaaaaaaaaaaaaaaaaaaaaaaaaaaaaaaaaaaaaaaaaaaaaaaaaaaaaaaaaaaaaaaaaaaaaaaaaaaaaaaaaaaaaaaaaaaaaaaaaaaaaaaaaaaaaaaaaaaaaaaaaaaaaaaaaaaaaaaaaaaaaaaaa
aaaaaaaaaaaaaaaaaaaaaaaaaaaaaaaaaaaaaaaaaaaaaaaaaaaaaaaaaaaaaaaaaaaaaaaaaaaaaaaaaaaaaaaaaaaaaaaaaaaaaaaaaaaaaaaaaaaaaaaaaaaaaaaaaaaaaaaaaaaaaaaaaaaaaa
aaaaaaaaaaaaaaaaaaaaaaaaaaaaaaaaaaaaaaaaaaaaaaaaaaaaaaaaaaaaaaaaaaaaaaaaaaaaaaaaaaaaaaaaaaaaaaaaaaaaaaaaaaaaaaaaaaaaaaaaaaaaaaaaaaaaaaaaaaaaaaaaaaaaaa
aaaaaaaaaaaaaaaaaaaaaaaaaaaaaaaaaaaaaaaaaaaaaaaaaaaaaaaaaaaaaaaaaaaaaaaaaaaaaaaaaaaaaaaaaaaaaaaaaaaaaaaaaaaaaaaaaaaaaaaaaaaaaaaaaaaaaaaaaaaaaaaaaaaaaa
aaaaaaaaaaaaaaaaaaaaaaaaaaaaaaaaaaaaaaaaaaaaaaaaaaaaaaaaaaaaaaaaaaaaaaaaaaaaaaaaaaaaaaaaaaaaaaaaaaaaaaaaaaaaaaaaaaaaaaaaaaaaaaaaaaaaaaaaaaaaaaaaaaaaaa
aaaaaaaaaaaaaaaaaaaaaaaaaaaaaaaaaaaaaaaaaaaaaaaaaaaaaaaaaaaaaaaaaaaaaaaaaaaaaaaaaaaaaaaaaaaaaaaaaaaaaaaaaaaaaaaaaaaaaaaaaaaaaaaaaaaaaaaaaaaaaaaaaaaaaa
aaaaaaaaaaaaaaaaaaaaaaaaaaaaaaaaaaaaaaaaaaaaaaaaaaaaaaaaaaaaaaaaaaaaaaaaaaaaaaaaaaaaaaaaaaaaaaaaaaaaaaaaaaaaaaaaaaaaaaaaaaaaaaaaaaaaaaaaaaaaaaaaaaaaaa
aaaaaaaaaaaaaaaaaaaaaaaaaaaaaaaaaaaaaaaaaaaaaaaaaaaaaaaaaaaaaaaaaaaaaaaaaaaaaaaaaaaaaaaaaaaaaaaaaaaaaaaaaaaaaaaaaaaaaaaaaaaaaaaaaaaaaaaaaaaaaaaaaaaaaa
aaaaaaaaaaaaaaaaaaaaaaaaaaaaaaaaaaaaaaaaaaaaaaaaaaaaaaaaaaaaaaaaaaaaaaaaaaaaaaaaaaaaaaaaaaaaaaaaaaaaaaaaaaaaaaaaaaaaaaaaaaaaaaaaaaaaaaaaaaaaaaaaaaaaaa
aaaaaaaaaaaaaaaaaaaaaaaaaaaaaaaaaaaaaaaaaaaaaaaaaaaaaaaaaaaaaaaaaaaaaaaaaaaaaaaaaaaaaaaaaaaaaaaaaaaaaaaaaaaaaaaaaaaaaaaaaaaaaaaaaaaaaaaaaaaaaaaaaaaaaa
aaaaaaaaaaaaaaaaaaaaaaaaaaaaaaaaaaaaaaaaaaaaaaaaaaaaaaaaaaaaaaaaaaaaaaaaaaaaaaaaaaaaaaaaaaaaaaaaaaaaaaaaaaaaaaaaaaaaaaaaaaaaaaaaaaaaaaaaaaaaaaaaaaaaaa
aaaaaaaaaaaaaaaaaaaaaaaaaaaaaaaaaaaaaaaaaaaaaaaaaaaaaaaaaaaaaaaaaaaaaaaaaaaaaaaaaaaaaaaaaaaaaaaaaaaaaaaaaaaaaaaaaaaaaaaaaaaaaaaaaaaaaaaaaaaaaaaaaaaaaa
aaaaaaaaaaaaaaaaaaaaaaaaaaaaaaaaaaaaaaaaaaaaaaaaaaaaaaaaaaaaaaaaaaaaaaaaaaaaaaaaaaaaaaaaaaaaaaaaaaaaaaaaaaaaaaaaaaaaaaaaaaaaaaaaaaaaaaaaaaaaaaaaaaaaaa
aaaaaaaaaaaaaaaaaaaaaaaaaaaaaaaaaaaaaaaaaaaaaaaaaaaaaaaaaaaaaaaaaaaaaaaaaaaaaaaaaaaaaaaaaaaaaaaaaaaaaaaaaaaaaaaaaaaaaaaaaaaaaaaaaaaaaaaaaaaaaaaaaaaaaa
aaaaaaaaaaaaaaaaaaaaaaaaaaaaaaaaaaaaaaaaaaaaaaaaaaaaaaaaaaaaaaaaaaaaaaaaaaaaaaaaaaaaaaaaaaaaaaaaaaaaaaaaaaaaaaaaaaaaaaaaaaaaaaaaaaaaaaaaaaaaaaaaaaaaaa
aaaaaaaaaaaaaaaaaaaaaaaaaaaaaaaaaaaaaaaaaaaaaaaaaaaaaaaaaaaaaaaaaaaaaaaaaaaaaaaaaaaaaaaaaaaaaaaaaaaaaaaaaaaaaaaaaaaaaaaaaaaaaaaaaaaaaaaaaaaaaaaaaaaaaa
aaaaaaaaaaaaaaaaaaaaaaaaaaaaaaaaaaaaaaaaaaaaaaaaaaaaaaaaaaaaaaaaaaaaaaaaaaaaaaaaaaaaaaaaaaaaaaaaaaaaaaaaaaaaaaaaaaaaaaaaaaaaaaaaaaaaaaaaaaaaaaaaaaaaaa
aaaaaaaaaaaaaaaaaaababababababababababababababababababababababababababababababababababababaaaaaaaaaaaaaaaaaaaaaaaaaaaaaaaaaaaaaaaaaaaaaaaaaaaaaaaaaaaa
aaaaaaaaaaaaaaaaaaabacadabaeafafafacagagagahahahacagaiajacahakalacamanaoapacagagagaqacarabaaaaaaaaaaaaaaaaaaaaaaaaaaaaaaaaaaaaaaaaaaaaaaaaaaaaaaaaaaaa
aaaaaaaaaaaaaaaaaaasacacasacafafafacatagagahahahacaiauavacawahalacacaxayayacagagazacacacabaaaaaaaaaaaaaaaaaaaaaaaaaaaaaaaaaaaaaaaaabababaaaaaaaaaaaaaa
aaaaaaaaaaaaaaaaaaasacacaAacafafafacagatagahahahacajavaBacawacacacacahayaoacazazagacacacabaaaaaaaaaaaaaaaaaCaCaCaCaCaCaCaCaCaCaCaCaCaDaEaFaaaaaaaaaaaa
aaaaaaaaaaaaaaaaaaasacacasaGaGaGaGaGaGaGaGaGaGaGaGaGaGaGaGaGaGaGaGaGaGaGaGaGaGaGaGaGaGaGabaaaaaaaaaaaaaaaaaCaCaHaCaCaCaCaIaJaKaLaMaCaDaNaOaaaaaaaaaaaa
aaaaaaaaaaaaaaaaaaasaPacasaQaQaqacacacacacacacafafafacaGaGacaRaRaRacacafafafacacahaSaSacabaTaTaTaTaTaTaTaTaCaUaUaCaVaWaXaYaYaYaYaZaCbaaaaaaaaaaaaaaaaa
aaaaaaaaaaaaaaaaaaasacacasaQavaiacacalahawacacafafafacaGaGacaRaRaRacacafafafacacaSaSaSbbbcbdbdbdbdbdbdbdbdbeaUaUbfaYaYbgaYaYaYaYbhaCbaaaaaaaaaaaaaaaaa
aaaaaaaaaaaaaaaaaaabbibjabavbkbkacacahakawacacafafafacaGaGacaRaRaRacacafafafacacaSaSaSblabaTaTaTaTaTaTaTaTaCbmaUaCaYaYaXbnaYbobpbpbqbaaaaaaaaaaaaaaaaa
aaaaaaaaaaaaaaaaaaabbrbsababababbtbtabababbtbtabababbuacbuacabababbtbtabababbtbtabababababaaaaaaaaaaaaaaaaaCaCaCaCbvbvaXbwbxaYbpbybzbaaaaaaaaaaaaaaaaa
aaaaaaaaaaaaaaaaaaabbibAabbBbCbDacacbEbEbEacacafafafacaGaGacafafafacacagagagacacahahahbFabaTaTaTaTaTaTaTaTaCbmaUaCaYaYaXbGaYbHbpbpbqbaaaaaaaaaaaaaaaaa
aaaaaaaaaaaaaaaaaaasacacasacacbBacacbEbEbEacacafafafacaGaGacafafafacacagagagacacahahahbbbcbdbdbdbdbdbdbdbdbeaUaUbfaYaYbgaYaYaYaYbhaCbaaaaaaaaaaaaaaaaa
aaaaaaaaaaaaaaaaaaasacadasacacacacacbEbEbEacacafafafaqaGaGacafafafacacagagagacacahahahacabaTaTaTaTaTaTaTaTaCaUaUaCbIbJaXbgaXaXaYbKaCbaaaaaaaaaaaaaaaaa
aaaaaaaaaaaaaaaaaaasadadasbLbLaGaGaGaGaGaGaGaGaGaGaGaGaGaGaGaGaGaGaGaGaGaGaGaGaGaGaGaGaGabaaaaaaaaaaaaaaaaaCaCaHaCaCaCaCbMbNaXbIbOaCaDbPaFaaaaaaaaaaaa
aaaaaaaaaaaaaaaaaaasbQacbRadbSafafacbTbUbUaQaQaQafafafacacawahbVbWbXacafafafacacacbYbYbYabaaaaaaaaaaaaaaaaaCaCaCaCaCaCaCaCaCaCaCaCaCaDaEaOaaaaaaaaaaaa
aaaaaaaaaaaaaaaaaaasadacbRacafafafacbUahahaQbCaQafafafacacahakbZcacbacafafafacccaccdcdcdabaaaaaaaaaaaaaaaaaaaaaaaaaaaaaaaaaaaaaaaaabababaaaaaaaaaaaaaa
aaaaaaaaaaaaaaaaaaabadacabceafafafacbUahahaQcfcgafafafacacalawchcicjacafafafacccaccdcdcdabaaaaaaaaaaaaaaaaaaaaaaaaaaaaaaaaaaaaaaaaaaaaaaaaaaaaaaaaaaaa
aaaaaaaaaaaaaaaaaaababababababababababababababababababababababababababababababababababababaaaaaaaaaaaaaaaaaaaaaaaaaaaaaaaaaaaaaaaaaaaaaaaaaaaaaaaaaaaa
aaaaaaaaaaaaaaaaaaaaaaaaaaaaaaaaaaaaaaaaaaaaaaaaaaaaaaaaaaaaaaaaaaaaaaaaaaaaaaaaaaaaaaaaaaaaaaaaaaaaaaaaaaaaaaaaaaaaaaaaaaaaaaaaaaaaaaaaaaaaaaaaaaaaaa
aaaaaaaaaaaaaaaaaaaaaaaaaaaaaaaaaaaaaaaaaaaaaaaaaaaaaaaaaaaaaaaaaaaaaaaaaaaaaaaaaaaaaaaaaaaaaaaaaaaaaaaaaaaaaaaaaaaaaaaaaaaaaaaaaaaaaaaaaaaaaaaaaaaaaa
aaaaaaaaaaaaaaaaaaaaaaaaaaaaaaaaaaaaaaaaaaaaaaaaaaaaaaaaaaaaaaaaaaaaaaaaaaaaaaaaaaaaaaaaaaaaaaaaaaaaaaaaaaaaaaaaaaaaaaaaaaaaaaaaaaaaaaaaaaaaaaaaaaaaaa
aaaaaaaaaaaaaaaaaaaaaaaaaaaaaaaaaaaaaaaaaaaaaaaaaaaaaaaaaaaaaaaaaaaaaaaaaaaaaaaaaaaaaaaaaaaaaaaaaaaaaaaaaaaaaaaaaaaaaaaaaaaaaaaaaaaaaaaaaaaaaaaaaaaaaa
aaaaaaaaaaaaaaaaaaaaaaaaaaaaaaaaaaaaaaaaaaaaaaaaaaaaaaaaaaaaaaaaaaaaaaaaaaaaaaaaaaaaaaaaaaaaaaaaaaaaaaaaaaaaaaaaaaaaaaaaaaaaaaaaaaaaaaaaaaaaaaaaaaaaaa
aaaaaaaaaaaaaaaaaaaaaaaaaaaaaaaaaaaaaaaaaaaaaaaaaaaaaaaaaaaaaaaaaaaaaaaaaaaaaaaaaaaaaaaaaaaaaaaaaaaaaaaaaaaaaaaaaaaaaaaaaaaaaaaaaaaaaaaaaaaaaaaaaaaaaa
aaaaaaaaaaaaaaaaaaaaaaaaaaaaaaaaaaaaaaaaaaaaaaaaaaaaaaaaaaaaaaaaaaaaaaaaaaaaaaaaaaaaaaaaaaaaaaaaaaaaaaaaaaaaaaaaaaaaaaaaaaaaaaaaaaaaaaaaaaaaaaaaaaaaaa
aaaaaaaaaaaaaaaaaaaaaaaaaaaaaaaaaaaaaaaaaaaaaaaaaaaaaaaaaaaaaaaaaaaaaaaaaaaaaaaaaaaaaaaaaaaaaaaaaaaaaaaaaaaaaaaaaaaaaaaaaaaaaaaaaaaaaaaaaaaaaaaaaaaaaa
aaaaaaaaaaaaaaaaaaaaaaaaaaaaaaaaaaaaaaaaaaaaaaaaaaaaaaaaaaaaaaaaaaaaaaaaaaaaaaaaaaaaaaaaaaaaaaaaaaaaaaaaaaaaaaaaaaaaaaaaaaaaaaaaaaaaaaaaaaaaaaaaaaaaaa
aaaaaaaaaaaaaaaaaaaaaaaaaaaaaaaaaaaaaaaaaaaaaaaaaaaaaaaaaaaaaaaaaaaaaaaaaaaaaaaaaaaaaaaaaaaaaaaaaaaaaaaaaaaaaaaaaaaaaaaaaaaaaaaaaaaaaaaaaaaaaaaaaaaaaa
aaaaaaaaaaaaaaaaaaaaaaaaaaaaaaaaaaaaaaaaaaaaaaaaaaaaaaaaaaaaaaaaaaaaaaaaaaaaaaaaaaaaaaaaaaaaaaaaaaaaaaaaaaaaaaaaaaaaaaaaaaaaaaaaaaaaaaaaaaaaaaaaaaaaaa
aaaaaaaaaaaaaaaaaaaaaaaaaaaaaaaaaaaaaaaaaaaaaaaaaaaaaaaaaaaaaaaaaaaaaaaaaaaaaaaaaaaaaaaaaaaaaaaaaaaaaaaaaaaaaaaaaaaaaaaaaaaaaaaaaaaaaaaaaaaaaaaaaaaaaa
aaaaaaaaaaaaaaaaaaaaaaaaaaaaaaaaaaaaaaaaaaaaaaaaaaaaaaaaaaaaaaaaaaaaaaaaaaaaaaaaaaaaaaaaaaaaaaaaaaaaaaaaaaaaaaaaaaaaaaaaaaaaaaaaaaaaaaaaaaaaaaaaaaaaaa
aaaaaaaaaaaaaaaaaaaaaaaaaaaaaaaaaaaaaaaaaaaaaaaaaaaaaaaaaaaaaaaaaaaaaaaaaaaaaaaaaaaaaaaaaaaaaaaaaaaaaaaaaaaaaaaaaaaaaaaaaaaaaaaaaaaaaaaaaaaaaaaaaaaaaa
aaaaaaaaaaaaaaaaaaaaaaaaaaaaaaaaaaaaaaaaaaaaaaaaaaaaaaaaaaaaaaaaaaaaaaaaaaaaaaaaaaaaaaaaaaaaaaaaaaaaaaaaaaaaaaaaaaaaaaaaaaaaaaaaaaaaaaaaaaaaaaaaaaaaaa
aaaaaaaaaaaaaaaaaaaaaaaaaaaaaaaaaaaaaaaaaaaaaaaaaaaaaaaaaaaaaaaaaaaaaaaaaaaaaaaaaaaaaaaaaaaaaaaaaaaaaaaaaaaaaaaaaaaaaaaaaaaaaaaaaaaaaaaaaaaaaaaaaaaaaa
aaaaaaaaaaaaaaaaaaaaaaaaaaaaaaaaaaaaaaaaaaaaaaaaaaaaaaaaaaaaaaaaaaaaaaaaaaaaaaaaaaaaaaaaaaaaaaaaaaaaaaaaaaaaaaaaaaaaaaaaaaaaaaaaaaaaaaaaaaaaaaaaaaaaaa
aaaaaaaaaaaaaaaaaaaaaaaaaaaaaaaaaaaaaaaaaaaaaaaaaaaaaaaaaaaaaaaaaaaaaaaaaaaaaaaaaaaaaaaaaaaaaaaaaaaaaaaaaaaaaaaaaaaaaaaaaaaaaaaaaaaaaaaaaaaaaaaaaaaaaa
aaaaaaaaaaaaaaaaaaaaaaaaaaaaaaaaaaaaaaaaaaaaaaaaaaaaaaaaaaaaaaaaaaaaaaaaaaaaaaaaaaaaaaaaaaaaaaaaaaaaaaaaaaaaaaaaaaaaaaaaaaaaaaaaaaaaaaaaaaaaaaaaaaaaaa
aaaaaaaaaaaaaaaaaaaaaaaaaaaaaaaaaaaaaaaaaaaaaaaaaaaaaaaaaaaaaaaaaaaaaaaaaaaaaaaaaaaaaaaaaaaaaaaaaaaaaaaaaaaaaaaaaaaaaaaaaaaaaaaaaaaaaaaaaaaaaaaaaaaaaa
aaaaaaaaaaaaaaaaaaaaaaaaaaaaaaaaaaaaaaaaaaaaaaaaaaaaaaaaaaaaaaaaaaaaaaaaaaaaaaaaaaaaaaaaaaaaaaaaaaaaaaaaaaaaaaaaaaaaaaaaaaaaaaaaaaaaaaaaaaaaaaaaaaaaaa
aaaaaaaaaaaaaaaaaaaaaaaaaaaaaaaaaaaaaaaaaaaaaaaaaaaaaaaaaaaaaaaaaaaaaaaaaaaaaaaaaaaaaaaaaaaaaaaaaaaaaaaaaaaaaaaaaaaaaaaaaaaaaaaaaaaaaaaaaaaaaaaaaaaaaa
aaaaaaaaaaaaaaaaaaaaaaaaaaaaaaaaaaaaaaaaaaaaaaaaaaaaaaaaaaaaaaaaaaaaaaaaaaaaaaaaaaaaaaaaaaaaaaaaaaaaaaaaaaaaaaaaaaaaaaaaaaaaaaaaaaaaaaaaaaaaaaaaaaaaaa
aaaaaaaaaaaaaaaaaaaaaaaaaaaaaaaaaaaaaaaaaaaaaaaaaaaaaaaaaaaaaaaaaaaaaaaaaaaaaaaaaaaaaaaaaaaaaaaaaaaaaaaaaaaaaaaaaaaaaaaaaaaaaaaaaaaaaaaaaaaaaaaaaaaaaa
aaaaaaaaaaaaaaaaaaaaaaaaaaaaaaaaaaaaaaaaaaaaaaaaaaaaaaaaaaaaaaaaaaaaaaaaaaaaaaaaaaaaaaaaaaaaaaaaaaaaaaaaaaaaaaaaaaaaaaaaaaaaaaaaaaaaaaaaaaaaaaaaaaaaaa
aaaaaaaaaaaaaaaaaaaaaaaaaaaaaaaaaaaaaaaaaaaaaaaaaaaaaaaaaaaaaaaaaaaaaaaaaaaaaaaaaaaaaaaaaaaaaaaaaaaaaaaaaaaaaaaaaaaaaaaaaaaaaaaaaaaaaaaaaaaaaaaaaaaaaa
aaaaaaaaaaaaaaaaaaaaaaaaaaaaaaaaaaaaaaaaaaaaaaaaaaaaaaaaaaaaaaaaaaaaaaaaaaaaaaaaaaaaaaaaaaaaaaaaaaaaaaaaaaaaaaaaaaaaaaaaaaaaaaaaaaaaaaaaaaaaaaaaaaaaaa
aaaaaaaaaaaaaaaaaaaaaaaaaaaaaaaaaaaaaaaaaaaaaaaaaaaaaaaaaaaaaaaaaaaaaaaaaaaaaaaaaaaaaaaaaaaaaaaaaaaaaaaaaaaaaaaaaaaaaaaaaaaaaaaaaaaaaaaaaaaaaaaaaaaaaa
aaaaaaaaaaaaaaaaaaaaaaaaaaaaaaaaaaaaaaaaaaaaaaaaaaaaaaaaaaaaaaaaaaaaaaaaaaaaaaaaaaaaaaaaaaaaaaaaaaaaaaaaaaaaaaaaaaaaaaaaaaaaaaaaaaaaaaaaaaaaaaaaaaaaaa
"}
