"a" = (/turf/unsimulated/wall,/area/planets/Geminus/outdoor/gauntlet)
"b" = (/turf/simulated/floor/exoplanet/desert,/area/planets/Geminus/outdoor/gauntlet)
"c" = (/turf/simulated/wall/covenant,/area/planets/Geminus/outdoor/gauntlet)
"d" = (/obj/structure/closet/crate/covenant,/obj/item/weapon/gun/projectile/type51carbine,/turf/simulated/floor/covenant,/area/planets/Geminus/outdoor/gauntlet)
"e" = (/obj/machinery/light/covenant/north,/turf/simulated/floor/covenant,/area/planets/Geminus/outdoor/gauntlet)
"f" = (/turf/simulated/floor/covenant,/area/planets/Geminus/outdoor/gauntlet)
"g" = (/obj/structure/closet/crate/covenant,/obj/item/weapon/gun/projectile/needler,/obj/item/weapon/gun/projectile/needler,/obj/item/weapon/gun/projectile/needler,/obj/item/weapon/gun/projectile/needler,/obj/item/weapon/gun/projectile/needler,/turf/simulated/floor/covenant,/area/planets/Geminus/outdoor/gauntlet)
"h" = (/obj/structure/closet/crate/covenant,/obj/item/ammo_magazine/needles,/obj/item/ammo_magazine/needles,/obj/item/ammo_magazine/needles,/obj/item/ammo_magazine/needles,/obj/item/ammo_magazine/needles,/turf/simulated/floor/covenant,/area/planets/Geminus/outdoor/gauntlet)
"i" = (/obj/structure/closet/crate/covenant,/obj/item/ammo_magazine/type51mag,/obj/item/ammo_magazine/type51mag,/turf/simulated/floor/covenant,/area/planets/Geminus/outdoor/gauntlet)
"j" = (/obj/structure/closet/crate/covenant,/obj/item/weapon/gun/energy/plasmapistol,/obj/item/weapon/gun/energy/plasmapistol,/obj/item/weapon/gun/energy/plasmapistol,/obj/item/weapon/gun/energy/plasmapistol,/obj/item/weapon/gun/energy/plasmapistol,/turf/simulated/floor/covenant,/area/planets/Geminus/outdoor/gauntlet)
"k" = (/obj/machinery/door/airlock/covenant,/turf/simulated/floor/covenant,/area/planets/Geminus/outdoor/gauntlet)
"l" = (/obj/structure/closet/crate/covenant,/obj/item/clothing/gloves/shield_gauntlet/kigyar,/obj/item/clothing/gloves/shield_gauntlet/kigyar,/obj/item/clothing/gloves/shield_gauntlet/kigyar,/obj/item/clothing/gloves/shield_gauntlet/kigyar,/obj/item/clothing/gloves/shield_gauntlet/kigyar,/turf/simulated/floor/covenant,/area/planets/Geminus/outdoor/gauntlet)
"m" = (/obj/machinery/light/covenant/south,/turf/simulated/floor/covenant,/area/planets/Geminus/outdoor/gauntlet)
"n" = (/obj/structure/closet/crate/covenant,/obj/item/weapon/melee/energy/elite_sword,/obj/item/weapon/melee/energy/elite_sword,/obj/item/weapon/melee/energy/elite_sword,/obj/item/weapon/melee/energy/elite_sword,/turf/simulated/floor/covenant,/area/planets/Geminus/outdoor/gauntlet)
"o" = (/obj/structure/window/reinforced/projresist/covenant{tag = "icon-window (EAST)"; icon_state = "window"; dir = 4},/obj/structure/window/reinforced/projresist/covenant{tag = "icon-window (WEST)"; icon_state = "window"; dir = 8},/turf/simulated/floor/covenant,/area/planets/Geminus/outdoor/gauntlet)
"p" = (/obj/machinery/light/covenant/west,/turf/simulated/floor/covenant,/area/planets/Geminus/outdoor/gauntlet)
"q" = (/obj/machinery/light/covenant/north,/turf/simulated/floor/exoplanet/desert,/area/planets/Geminus/outdoor/gauntlet)
"r" = (/obj/machinery/light/covenant/east,/turf/simulated/floor/covenant,/area/planets/Geminus/outdoor/gauntlet)
"s" = (/obj/machinery/light/covenant/south,/turf/simulated/floor/exoplanet/desert,/area/planets/Geminus/outdoor/gauntlet)
"t" = (/obj/machinery/message_server,/turf/simulated/floor/covenant,/area/planets/Geminus/outdoor/gauntlet)
"u" = (/obj/machinery/photocopier/faxmachine{department = "Missionary Ship"; icon = 'code/modules/halo/icons/machinery/covenant/consoles.dmi'; icon_state = "covie_console"; name = "Superluminal Communications Array"; tag = "icon-covie_console"},/turf/simulated/floor/covenant,/area/planets/Geminus/outdoor/gauntlet)
"v" = (/obj/machinery/light/covenant/east,/turf/simulated/floor/exoplanet/desert,/area/planets/Geminus/outdoor/gauntlet)
"w" = (/obj/machinery/light/covenant/west,/turf/simulated/floor/exoplanet/desert,/area/planets/Geminus/outdoor/gauntlet)
"x" = (/obj/structure/window/reinforced/projresist/covenant,/obj/structure/window/reinforced/projresist/covenant{tag = "icon-window (NORTH)"; icon_state = "window"; dir = 1},/turf/simulated/floor/covenant,/area/planets/Geminus/outdoor/gauntlet)
"y" = (/turf/simulated/wall/wood,/area/planets/Geminus/outdoor/gauntlet)
"z" = (/obj/machinery/door/unpowered/simple/wood,/turf/simulated/floor/wood,/area/planets/Geminus/outdoor/gauntlet)
"A" = (/turf/simulated/floor/wood,/area/planets/Geminus/outdoor/gauntlet)
"B" = (/mob/living/carbon/human{l_ear = /obj/item/device/radio/headset/unsc/odst; w_uniform = /obj/item/clothing/under/unsc/odst_jumpsuit},/turf/simulated/floor/exoplanet/desert,/area/planets/Geminus/outdoor/gauntlet)
"C" = (/obj/structure/window/framed,/turf/simulated/floor/wood,/area/planets/Geminus/outdoor/gauntlet)
"D" = (/obj/machinery/light/invis,/turf/simulated/floor/wood,/area/planets/Geminus/outdoor/gauntlet)
"E" = (/obj/machinery/vending/armory/attachment{req_access = list()},/turf/simulated/floor/wood,/area/planets/Geminus/outdoor/gauntlet)
"F" = (/obj/machinery/vending/odstvend{req_access = list()},/turf/simulated/floor/wood,/area/planets/Geminus/outdoor/gauntlet)

(1,1,1) = {"
aaaaaaaaaaaaaaaaaaaaaaaaaaaaaaaaaaaaaaaaaaaaaaaaaaaaaaaaaaaaaaaaaaaaaa
abbbbbbbbbbbbbbbbbbbbbbbbbbbbbbbbbbbbbbbbbbbbbbbbbbbbbbbbbbbbbbbbbbbba
abbbbbbbbbbbbbbbbbbbbbbbbbbbbbbbbbbbbbbbbbbbbbbbbbbbbbbbbbbbbbbbbbbbba
abbbbbbbbbbbbbbbbbbbbbbbbbbbbbbbbbbbbbbbbbbbbbbbbbbbbbbbbbbbbbbbbbbbba
abbbbbbbbbbbbbbbbbbbbbbbbbbbbbbbbbbbbbbbbbbbbbbbbbbbbbbbbbbbbbbbbbbbba
abbbbbbbbbbbbbbbbbbbbbbbbbbbbbbbbbbbbbbbbbbbbbbbbbbbbbbbbbbbbbbbbbbbba
abbbbbbbbbbbbbbbbbbbbbbbbbbbbbbbbbbbbbbbbbbbbbbbbbbbbbbbbbbbbbbbbbbbba
abbbbbbbbbbbbbbbbbbbbbbbbbbbbbcccccccccbbbbbbbbbbbbbbbbbbbbbbbbbbbbbba
abbbbbbbbbbbbbbbbbbbbbbbbbbbbbcdefgfehcbbbbbbbbbbbbbbbbbbbbbbbbbbbbbba
abbbbbbbbbbbbbbbbbbbbbbbbbbbbbcfffffffcbbbbbbbbbbbbbbbbbbbbbbbbbbbbbba
abbbbbbbbbbbbbbbbbbbbbbbbbbbbbcifffffjcbbbbbbbbbbbbbbbbbbbbbbbbbbbbbba
abbbbbbbbbbbbbbbbbbbckkcbbbbbbcfffffffcbbbbbbckkcbbbbbbbbbbbbbbbbbbbba
abbbbbbbbbbbbbbbbbbbcffcbbbbbbclmfffmncbbbbbbcffcbbbbbbbbbbbbbbbbbbbba
abbbbbbbbbbbbbbbbbbboffcbbbbbbcccckccccbbbbbbcffobbbbbbbbbbbbbbbbbbbba
abbbbbbbbbbbbbbbbbbbcpfcbbbbbbbbqbbbqbbbbbbbbcfrcbbbbbbbbbbbbbbbbbbbba
abbbbbbbbbbbbbbbbbbboffcbbbbbbbbbbbbbbbbbbbbbcffobbbbbbbbbbbbbbbbbbbba
abbbbbbbbbbbbbbbbbbbcffcbbbbbbbbbbbbbbbbbbbbbcffcbbbbbbbbbbbbbbbbbbbba
abbbbbbbbbbbbbbbbbbbckkcbbbbbbbbbbbbbbbbbbbbbckkcbbbbbbbbbbbbbbbbbbbba
abbbbbbbbbbbbbbbbbbbqffbbbbbbbbbbbbbbbbbbbbbbbffqbbbbbbbbbbbbbbbbbbbba
abbbbbbbbbbbbbbbbbbbbffbbbbbbbbbbbbbbbbbbbbbbbffbbbbbbbbbbbbbbbbbbbbba
abbbbbbbbbbbbbbbbbbbbffsbbbbbbbbbbbbbbbbbbbbbsffbbbbbbbbbbbbbbbbbbbbba
abbbbbbbbbbbbbbbbbbbckkcbbbbbbbbsbbbsbbbbbbbbckkcbbbbbbbbbbbbbbbbbbbba
abbbbbbbbbbbbbbbbbbbcffcbbbbbbbccckcccbbbbbbbcffcbbbbbbbbbbbbbbbbbbbba
abbbbbbbbbbbbbbbbbbboffcbbbbbbbcfffffcbbbbbbbcffobbbbbbbbbbbbbbbbbbbba
abbbbbbbbbbbbbbbbbbbcpfcbbbbbbbctfffucbbbbbbbcfrcbbbbbbbbbbbbbbbbbbbba
abbbbbbbbbbbbbbbbbbboffcbbbbbbbcffmffcbbbbbbbcffobbbbbbbbbbbbbbbbbbbba
abbbbbbbbbbbbbbbbbbbcffccccbbvcccccccccwbbccccffcbbbbbbbbbbbbbbbbbbbba
abbbbbbbbbbbbbbbbbbbofffffkfffkfffefffkfffkfffffobbbbbbbbbbbbbbbbbbbba
abbbbbbbbbbbbbbbbbbbcffmffkfffkfffffffkfffkffmffcbbbbbbbbbbbbbbbbbbbba
abbbbbbbbbbbbbbbbbbbccxcxccwbbcxccxccxcbbvccxcxccbbbbbbbbbbbbbbbbbbbba
abbbbbbbbbbbbbbbbbbbbbbbbbbbbbbbbbbbbbbbbbbbbbbbbbbbbbbbbbbbbbbbbbbbba
abbbbbbbbbbbbbbbbbbbbbbbbbbbbbbbbbbbbbbbbbbbbbbbbbbbbbbbbbbbbbbbbbbbba
abbbbbbbbbbbbbbbbbbbbbbbbbbbbbbbbbbbbbbbbbbbbbbbbbbbbbbbbbbbbbbbbbbbba
abbbbbbbbbbbbbbbbbbbbbbbbbbbbbbbbbbbbbbbbbbbbbbbbbbbbbbbbbbbbbbbbbbbba
abbbbbbbbbbbbbbbbbbbbbbbbbbbbbbbbbbbbbbbbbbbbbbbbbbbbbbbbbbbbbbbbbbbba
abbbbbbbbbbbbbbbbbbbbbbbbbbbbbbbbbbbbbbbbbbbbbbbbbbbbbbbbbbbbbbbbbbbba
abbbbbbbbbbbbbbbbbbbbbbbbbbbbbbbbbbbbbbbbbbbbbbbbbbbbbbbbbbbbbbbbbbbba
abbbbbbbbbbbbbbbbbbbbbbbbbbbbbbbbbbbbbbbbbbbbbbbbbbbbbbbbbbbbbbbbbbbba
abbbbbbbbbbbbbbbbbbbbbbbbbbbbbbbbbbbbbbbbbbbbbbbbbbbbbbbbbbbbbbbbbbbba
abbbbbbbbbbbbbbbbbbbbbbbbbbbbbbbbbbbbbbbbbbbbbbbbbbbbbbbbbbbbbbbbbbbba
abbbbbbbbbbbbbbbbbbbbbbbbbbbbbbbbbbbbbbbbbbbbbbbbbbbbbbbbbbbbbbbbbbbba
abbbbbbbbbbbbbbbbbbbbbbbbbbbbbbbbbbbbbbbbbbbbbbbbbbbbbbbbbbbbbbbbbbbba
abbbbbbbbbbbbbbbbbbbbbbbbbbbbbbbbbbbbbbbbbbbbbbbbbbbbbbbbbbbbbbbbbbbba
abbbbbbbbbbbbbbbbbbbbbbbbbbbbbbbbbbbbbbbbbbbbbbbbbbbbbbbbbbbbbbbbbbbba
abbbbbbbbbbbbbbbbbbbbbbbbbbbbbbbbbbbbbbbbbbbbbbbbbbbbbbbbbbbbbbbbbbbba
abbbbbbbbbbbbbbbbbbbbbbbbbbbbbbbbbbbbbbbbbbbbbbbbbbbbbbbbbbbbbbbbbbbba
abbbbbbbbbbbbbbbbbbbbbbbbbbbbbbbbbbbbbbbbbbbbbbbbbbbbbbbbbbbbbbbbbbbba
abbbbbbbbbbbbbbbbbbbbbbbbbbbbbbbbbbbbbbbbbbbbbbbbbbbbbbbbbbbbbbbbbbbba
abbbbbbbbbbbbbbbbbbbbbbbbbbbbbbbbbbbbbbbbbbbbbbbbbbbbbbbbbbbbbbbbbbbba
abbbbbbbbbbbbbbbbbbbbbbbbbbbbbbbbbbbbbbbbbbbbbbbbbbbbbbbbbbbbbbbbbbbba
abbbbbbbbbbbbbbbbbbbbbbbbbbbbbbbbbbbbbbbbbbbbbbbbbbbbbbbbbbbbbbbbbbbba
abbbbbbbbbbbbbbbbbbbbbbbbbbbbbbbbbbbbbbbbbbbbbbbbbbbbbbbbbbbbbbbbbbbba
abbbbbbbbbbbbbbbbbbbbbbbbbbbbbbbbbbbbbbbbbbbbbbbbbbbbbbbbbbbbbbbbbbbba
abbbbbbbbbbbbbbbbbbbbbbbbbbbbbbbbbbbbbbbbbbbbbbbbbbbbbbbbbbbbbbbbbbbba
abbbbbbbbbbbbbbbbbbbbbbbbbbbbbbbbbbbbbbbbbbbbbbbbbbbbbbbbbbbbbbbbbbbba
abbbbbbbbbbbbbbbbbbbbbbbbbbbbbbbbbbbbbbbbbbbbbbbbbbbbbbbbbbbbbbbbbbbba
abbbbbbbbbbbbbbbbbbbbbbbbbbbbbbbbbbbbbbbbbbbbbbbbbbbbbbbbbbbbbbbbbbbba
abbbbbbbbbbbbbbbbbbbbbbbbbbbbbbbbbbbbbbbbbbbbbbbbbbbbbbbbbbbbbbbbbbbba
abbbbbbbbbbbbbbbbbbbbbbbbbbbbbbbbbbbbbbbbbbbbbbbbbbbbbbbbbbbbbbbbbbbba
abbbbbbbbbbbbbbbbbbbbbbbbbbbbbbbbbbbbbbbbbbbbbbbbbbbbbbbbbbbbbbbbbbbba
abbbbbbbbbbbbbbbbbbbbbbbbbbbbbbbbbbbbbbbbbbbbbbbbbbbbbbbbbbbbbbbbbbbba
abbbbbbbbbbbbbbbbbbbbbbbbbbbbbbbbbbbbbbbbbbbbbbbbbbbbbbbbbbbbbbbbbbbba
abbbbbbbbbbbbbbbbbbbbbbbbbbbbbbbbbbbbbbbbbbbbbbbbbbbbbbbbbbbbbbbbbbbba
abbbbbbbbbbbbbbbbbbbbbbbbbbbbbbbyyzyybbbbbbbbbbbbbbbbbbbbbbbbbbbbbbbba
abbbbbbbbbbbbbbbbbbbbbbbbbbbbbbbyAAAybbbbbbbbbbbbbbbbbbbbbbbbbbbbbbbba
abbbbbbbbbbbbbbbbbbbbbbbbbbbBbbbCADACbbbbbbbbbbbbbbbbbbbbbbbbbbbbbbbba
abbbbbbbbbbbbbbbbbbbbbbbbbbbbbbbCAAACbbbbbbbbbbbbbbbbbbbbbbbbbbbbbbbba
abbbbbbbbbbbbbbbbbbbbbbbbbbbbbbbCEDFCbbbbbbbbbbbbbbbbbbbbbbbbbbbbbbbba
abbbbbbbbbbbbbbbbbbbbbbbbbbbbbbbyyyyybbbbbbbbbbbbbbbbbbbbbbbbbbbbbbbba
aaaaaaaaaaaaaaaaaaaaaaaaaaaaaaaaaaaaaaaaaaaaaaaaaaaaaaaaaaaaaaaaaaaaaa
"}
